R 640 480

F 194,167,168
C 162,188,201

NO ./srcs/n.xpm
SO ./srcs/stone.xpm
WE ./srcs/wood.xpm
EA ./srcs/tree.xpm

S  ./srcs/sprite.xpm

        1111111111111111111111111
        1000000000110000000000001
        1011000001110000002000001
        1001000000000000000000001
111111111011000001110000000000001
100000000011000001110111100011111
11110111111111011100000010001
1110111111111011101010012001
1100000011010101110000010201
10002000000000001100000010201
10000000000000001101010010001
11000001110101011111011110W0111
11110111 1110101 101111010001 
11111111 111111 111111111111
