R 640 480

F 194,167,168
C 162,188,201

NO ./srcs/n.xpm
SO ./srcs/stone.xpm
WE ./srcs/wood.xpm
EA ./srcs/tree.xpm

S ./srcs/sprite.xpm
B ./srcs/bottle.xpm

111111
120101
130101
100031
1022221
1120N1
111111
